25
9
3,0,0,0,0,0,0,0,0,0,0,0,0,0,0,0,0,0,0,0,0,0,0,0,1,
6,0,0,0,0,0,0,0,0,0,0,0,0,0,0,0,0,0,0,0,0,0,0,0,4,
6,0,0,0,0,0,0,0,0,0,0,b,0,0,0,0,0,b,0,0,0,0,b,0,4,
6,0,0,0,0,0,0,0,0,0,0,0,0,0,0,0,0,c,0,0,0,0,0,0,4,
6,0,0,0,0,0,0,0,0,c,0,0,0,0,0,0,0,0,0,0,0,0,c,0,4,
6,0,0,0,0,0,0,0,0,0,0,0,b,c,0,0,13,15,0,0,0,0,c,0,4,
6,0,0,0,0,c,c,0,0,0,0,0,0,0,0,0,0,0,0,b,0,0,0,0,4,
6,0,0,0,0,0,0,0,0,1,2,3,0,0,0,0,0,c,0,0,0,0,0,0,4,
10,11,2,2,2,2,2,2,2,2,2,2,2,2,2,2,2,2,2,2,2,2,2,7,8

