40
9
3,0,0,0,0,0,0,0,0,0,0,0,0,0,0,0,0,0,0,0,0,0,0,0,0,0,0,0,0,0,0,0,0,0,0,0,0,0,0,1,
6,0,0,0,0,0,0,0,0,0,0,0,0,0,0,0,0,0,0,0,0,0,0,0,0,0,0,0,0,0,0,0,0,0,0,0,0,0,0,4,
6,0,0,0,0,0,0,0,0,0,b,0,0,0,0,0,0,0,0,0,0,b,0,0,0,0,0,b,0,c,c,b,0,c,c,c,0,b,0,4,
6,0,0,0,0,0,0,0,0,0,0,0,0,0,0,0,0,0,c,c,0,0,0,0,0,0,0,0,0,0,0,0,0,0,0,0,0,0,0,4,
6,0,0,0,0,0,0,0,0,c,c,0,0,0,0,0,0,0,0,0,0,c,0,0,0,c,c,0,0,0,0,1,2,2,2,2,2,3,c,4,
6,0,0,0,0,0,0,0,0,c,c,0,0,0,0,14,15,15,16,0,0,0,0,0,0,0,0,0,0,0,0,12,9,9,9,9,9,13,c,4,
6,0,0,0,0,0,0,0,1,2,3,0,0,0,0,0,0,0,0,b,0,0,0,0,1,2,2,3,0,0,0,0,0,b,c,c,0,0,0,4,
6,0,0,0,0,1,2,2,2,2,2,3,0,0,0,0,c,c,0,0,0,1,3,0,4,5,5,10,11,3,0,0,0,0,c,c,0,0,0,4,
10,11,2,2,7,8,5,5,5,5,5,10,11,2,2,2,2,2,2,2,2,2,2,7,2,2,2,2,2,2,2,2,2,2,2,2,2,2,7,8

